Tomato - Hybrid (Tamatar)
Green Peas (Matar)
Cauliflower - Large (Phool Gobhi)
Kinnow - Small (2 pcs)
Bikano Patisa Sweet (Best Before - 31st Jan 2024)
Fenugreek (Methi)
Banana - Medium
Potato - Fresh Crop (Aloo)
Onion (Pyaaz)
Beans - French (Phali)
Coriander - With Roots (Hara Dhaniya)
Lemon - Desi (Nimbu)
Desi Safed Makhan - Murthal Style (Made from 100 percent Buffalo Milk)
Apple - Large
Tender Coconut
Farmers Moo Cow Paneer
Coriander Leaves - Without Roots (Dhaniya)
Chilli - Hybrid (Hari Mirch)
Kiwi - Green (Small) - Imported
Sprouts - Moong
Sweet Lime - Greenish Yellow (Small)
Watermelon - Medium (Tarbuj)
Pineapple - Rani (Whole Ananas)
Tender Coconut
Sweet Lime - Greenish Yellow (Medium)
Rajdhani Besan (Best Before - 11th Jan 2024)
Haldiram Dry Fruit Panjeri Ladoo (Best Before - 7th Feb 2024)
Rajdhani Atta
Glonuts Regular Almonds (Badaam)
Gaj Desi Ghee